constraint Amphisbaenia hard = Amphisbaena_fuliginosa Bipes_biporus Bipes_canaliculatus Diplometopon_zarudnyi Geocalamus_acutus Rhineura_floridana Trogonophis_wiegmanni;
constraint Anguimorpha hard = Anniella_pulchra Celestus_enneagrammus Elgaria_multicarinata Heloderma_horridum Heloderma_suspectum Lanthanotus_borneensis Shinisaurus_crocodilurus Varanus_acanthurus Varanus_exanthematicus Varanus_salvator Xenosaurus_grandis Xenosaurus_platyceps Pseudopus_apodus;
constraint Dibamidae hard = Anelytropsis_papillosus Dibamus_novaeguineae;
constraint Gekkota hard = Aeluroscalobates_felinus Coleonyx_variegatus Delma_borea Eublepharis_macularius Gekko_gecko Gonatodes_albogularis Lialis_burtonis Phelsuma_lineata Rhacodactylus_auriculatus Saltuarius_cornutus Strophurus_ciliaris Teratoscincus;
constraint Gymnophthalmidae hard = Colobosaura_modesta Pholidobolus;
constraint Iguania hard = Agama_agama Anolis_carolinensis Basiliscus_basiliscus Brachylophus_fasciatus Brookesia_brygooi Calotes_emma Chalarodon_madagascariensis Chamaeleo Corytophanes_cristatus Crotaphytus_collaris Dipsosaurus_dorsalis Enyalioides_laticeps Gambelia_wislizenii Hydrosaurus Leiocephalus_barahonensis Leiolepis_belliana Leiosaurus_catamarcensis Liolaemus_bellii Morunasaurus_annularis Oplurus_cyclurus Petrosaurus_mearnsi Phrynosoma_platyrhinos Phymaturus_palluma Physignathus_cocincinus Pogona_vitticeps Polychrus_marmoratus Pristidactylus_torquatus Sauromalus_ater Sceloporus_variabilis Stenocercus_guentheri Uma_scoparia Uranoscodon_superciliosus Uromastyx_aegyptus Urostrophus_vautieri Uta_stansburiana Plica_plica;
constraint Lacertidae hard = Lacerta_viridis Takydromus_ocellatus;
constraint Scincoidea hard = Acontias Amphiglossus_splendidus Brachymeles_gracilis Cordylosaurus_subtesselatus Cordylus_mossambicus Cricosaura_typica Eugongylus_rufescens Feylinia_polylepis Lepidophyma_flavimaculatu Platysaurus Plestiodon_fasciatus Scincus Sphenomorphus_solomonis Tiliqua_scincoides Trachylepis_quinquetaeniata Xantusia_vigilis Zonosaurus_ornatus;
constraint Teiidae hard = Aspidoscelis_tigris Callopistes_maculatus Teius_teyou Tupinambis_teguixin;
constraint Outgroup2 hard = Alligator Chelydra Crocodylus Dromaius Gallus Mus Podocnemis Sphenodon_punctatus Tachyglos Homo;
constraint Boidae hard = Boa_constrictor Calabaria_reinhardtii Epicrates_striatus Eryx_colubrinus Exiliboa_placata Lichanura_trivirgata Ungaliophis_continentalis;
constraint Colubroidea hard = Afronatrix_anoscopus Amphiesma_stolata Coluber_constrictor Diadophis_punctatus Homalopsis_buccata Lampropeltis_getula Natrix_natrix Pareas_hamptoni Thamnophis_marcianus Xenochrophis_piscator Xenodermus_javanicus;
constraint Elapoidea hard = Aparallactus_werneri Atractaspis_irregularis Laticauda_colubrina Lycophidion_capense Micrurus_fulvius Naja Notechis_scutatus;
constraint Pythonidae hard = Aspidites_melanocephalus Python_molurus;
constraint Tropidophiidae hard = Trachyboa_boulengeri Tropidophis_haetianus;
constraint Viperidae hard = Agkistrodon_contortrix Azemiops_feae Bothrops_asper Causus Daboia_russelli Lachesis_muta;
constraint Amphisbaenidae hard = Amphisbaena_fuliginosa Geocalamus_acutus;
constraint Bipedidae hard = Bipes_biporus Bipes_canaliculatus;
constraint Trogonophiidae hard = Diplometopon_zarudnyi Trogonophis_wiegmanni;
constraint Anguidae hard = Elgaria_multicarinata Pseudopus_apodus;
constraint Helodermatidae hard = Heloderma_horridum Heloderma_suspectum;
constraint Varanidae hard = Varanus_acanthurus Varanus_exanthematicus Varanus_salvator;
constraint Xenosauridae hard = Xenosaurus_grandis Xenosaurus_platyceps;
constraint Eublepharidae hard = Aeluroscalobates_felinus Coleonyx_variegatus Eublepharis_macularius;
constraint Pygopodidae hard = Delma_borea Lialis_burtonis;
constraint Gekkonidae hard = Gekko_gecko Phelsuma_lineata;
constraint Sphaerodactylidae hard = Gonatodes_albogularis Teratoscincus;
constraint Diplodactylidae hard = Rhacodactylus_auriculatus Strophurus_ciliaris;
constraint Agamidae hard = Agama_agama Calotes_emma Hydrosaurus Leiolepis_belliana Physignathus_cocincinus Pogona_vitticeps Uromastyx_aegyptus;
constraint Corytophanidae hard = Basiliscus_basiliscus Corytophanes_cristatus;
constraint Iguanidae hard = Brachylophus_fasciatus Dipsosaurus_dorsalis Sauromalus_ater;
constraint Chamaeleonidae hard = Brookesia_brygooi Chamaeleo;
constraint Opluridae hard = Chalarodon_madagascariensis Oplurus_cyclurus;
constraint Crotaphytidae hard = Crotaphytus_collaris Gambelia_wislizenii;
constraint Hoplocercidae hard = Enyalioides_laticeps Morunasaurus_annularis;
constraint Leiosauridae hard = Leiosaurus_catamarcensis Pristidactylus_torquatus Urostrophus_vautieri;
constraint Liolaemidae hard = Liolaemus_bellii Phymaturus_palluma;
constraint Phrynosomatidae hard = Petrosaurus_mearnsi Phrynosoma_platyrhinos Sceloporus_variabilis Uma_scoparia Uta_stansburiana;
constraint Tropiduridae hard = Stenocercus_guentheri Uranoscodon_superciliosus Plica_plica;
constraint Scincidae hard = Acontias Amphiglossus_splendidus Brachymeles_gracilis Eugongylus_rufescens Feylinia_polylepis Plestiodon_fasciatus Scincus Sphenomorphus_solomonis Tiliqua_scincoides Trachylepis_quinquetaeniata;
constraint Gerrhosauridae hard = Cordylosaurus_subtesselatus Zonosaurus_ornatus;
constraint Cordylidae hard = Cordylus_mossambicus Platysaurus;
constraint Xantusiidae hard = Cricosaura_typica Lepidophyma_flavimaculatu Xantusia_vigilis;
constraint Outgroup hard = Alligator Chelydra Crocodylus Dromaius Gallus Mus Podocnemis Tachyglos Homo;
constraint Boidae hard = Boa_constrictor Epicrates_striatus;
constraint Charinidae hard = Exiliboa_placata Lichanura_trivirgata Ungaliophis_continentalis;
constraint Natricidae hard = Afronatrix_anoscopus Amphiesma_stolata Natrix_natrix Thamnophis_marcianus Xenochrophis_piscator;
constraint Colubridae hard = Coluber_constrictor Lampropeltis_getula;
constraint Atractaspididae hard = Aparallactus_werneri Atractaspis_irregularis;
constraint Elapidae hard = Laticauda_colubrina Micrurus_fulvius Naja Notechis_scutatus;
constraint Snake hard = Acrochordus_granulatus Anilius_scytale Liotyphlops_albirostris Boa_constrictor Calabaria_reinhardtii Epicrates_striatus Eryx_colubrinus Exiliboa_placata Lichanura_trivirgata Ungaliophis_continentalis Casarea_dussumieri Afronatrix_anoscopus Amphiesma_stolata Coluber_constrictor Diadophis_punctatus Homalopsis_buccata Lampropeltis_getula Natrix_natrix Pareas_hamptoni Thamnophis_marcianus Xenochrophis_piscator Xenodermus_javanicus Cylindrophis_rufus Aparallactus_werneri Atractaspis_irregularis Laticauda_colubrina Lycophidion_capense Micrurus_fulvius Naja Notechis_scutatus Leptotyphlops Loxocemus_bicolor Aspidites_melanocephalus Python_molurus Trachyboa_boulengeri Tropidophis_haetianus Typhlops_jamaicensis Uropeltis_melanogaster Agkistrodon_contortrix Azemiops_feae Bothrops_asper Causus Daboia_russelli Lachesis_muta Xenopeltis_unicolor;
constraint Sclero hard = Amphisbaena_fuliginosa Bipes_biporus Bipes_canaliculatus Diplometopon_zarudnyi Geocalamus_acutus Rhineura_floridana Trogonophis_wiegmanni Anniella_pulchra Celestus_enneagrammus Elgaria_multicarinata Heloderma_horridum Heloderma_suspectum Lanthanotus_borneensis Shinisaurus_crocodilurus Varanus_acanthurus Varanus_exanthematicus Varanus_salvator Xenosaurus_grandis Xenosaurus_platyceps Pseudopus_apodus Anelytropsis_papillosus Dibamus_novaeguineae Aeluroscalobates_felinus Coleonyx_variegatus Delma_borea Eublepharis_macularius Gekko_gecko Gonatodes_albogularis Lialis_burtonis Phelsuma_lineata Rhacodactylus_auriculatus Saltuarius_cornutus Strophurus_ciliaris Teratoscincus Colobosaura_modesta Pholidobolus Lacerta_viridis Takydromus_ocellatus Acontias Amphiglossus_splendidus Brachymeles_gracilis Cordylosaurus_subtesselatus Cordylus_mossambicus Cricosaura_typica Eugongylus_rufescens Feylinia_polylepis Lepidophyma_flavimaculatu Platysaurus Plestiodon_fasciatus Scincus Sphenomorphus_solomonis Tiliqua_scincoides Trachylepis_quinquetaeniata Xantusia_vigilis Zonosaurus_ornatus Aspidoscelis_tigris Callopistes_maculatus Teius_teyou Tupinambis_teguixin Acrochordus_granulatus Anilius_scytale Liotyphlops_albirostris Boa_constrictor Calabaria_reinhardtii Epicrates_striatus Eryx_colubrinus Exiliboa_placata Lichanura_trivirgata Ungaliophis_continentalis Casarea_dussumieri Afronatrix_anoscopus Amphiesma_stolata Coluber_constrictor Diadophis_punctatus Homalopsis_buccata Lampropeltis_getula Natrix_natrix Pareas_hamptoni Thamnophis_marcianus Xenochrophis_piscator Xenodermus_javanicus Cylindrophis_rufus Aparallactus_werneri Atractaspis_irregularis Laticauda_colubrina Lycophidion_capense Micrurus_fulvius Naja Notechis_scutatus Leptotyphlops Loxocemus_bicolor Aspidites_melanocephalus Python_molurus Trachyboa_boulengeri Tropidophis_haetianus Typhlops_jamaicensis Uropeltis_melanogaster Agkistrodon_contortrix Azemiops_feae Bothrops_asper Causus Daboia_russelli Lachesis_muta Xenopeltis_unicolor;
constraint ToxPoly hard = Anniella_pulchra Celestus_enneagrammus Elgaria_multicarinata Heloderma_horridum Heloderma_suspectum Lanthanotus_borneensis Shinisaurus_crocodilurus Varanus_acanthurus Varanus_exanthematicus Varanus_salvator Xenosaurus_grandis Xenosaurus_platyceps Pseudopus_apodus Agama_agama Anolis_carolinensis Basiliscus_basiliscus Brachylophus_fasciatus Brookesia_brygooi Calotes_emma Chalarodon_madagascariensis Chamaeleo Corytophanes_cristatus Crotaphytus_collaris Dipsosaurus_dorsalis Enyalioides_laticeps Gambelia_wislizenii Hydrosaurus Leiocephalus_barahonensis Leiolepis_belliana Leiosaurus_catamarcensis Liolaemus_bellii Morunasaurus_annularis Oplurus_cyclurus Petrosaurus_mearnsi Phrynosoma_platyrhinos Phymaturus_palluma Physignathus_cocincinus Pogona_vitticeps Polychrus_marmoratus Pristidactylus_torquatus Sauromalus_ater Sceloporus_variabilis Stenocercus_guentheri Uma_scoparia Uranoscodon_superciliosus Uromastyx_aegyptus Urostrophus_vautieri Uta_stansburiana Plica_plica Acrochordus_granulatus Anilius_scytale Liotyphlops_albirostris Boa_constrictor Calabaria_reinhardtii Epicrates_striatus Eryx_colubrinus Exiliboa_placata Lichanura_trivirgata Ungaliophis_continentalis Casarea_dussumieri Afronatrix_anoscopus Amphiesma_stolata Coluber_constrictor Diadophis_punctatus Homalopsis_buccata Lampropeltis_getula Natrix_natrix Pareas_hamptoni Thamnophis_marcianus Xenochrophis_piscator Xenodermus_javanicus Cylindrophis_rufus Aparallactus_werneri Atractaspis_irregularis Laticauda_colubrina Lycophidion_capense Micrurus_fulvius Naja Notechis_scutatus Leptotyphlops Loxocemus_bicolor Aspidites_melanocephalus Python_molurus Trachyboa_boulengeri Tropidophis_haetianus Typhlops_jamaicensis Uropeltis_melanogaster Agkistrodon_contortrix Azemiops_feae Bothrops_asper Causus Daboia_russelli Lachesis_muta Xenopeltis_unicolor;
constraint ToxAI hard = Anniella_pulchra Celestus_enneagrammus Elgaria_multicarinata Heloderma_horridum Heloderma_suspectum Lanthanotus_borneensis Shinisaurus_crocodilurus Varanus_acanthurus Varanus_exanthematicus Varanus_salvator Xenosaurus_grandis Xenosaurus_platyceps Pseudopus_apodus Agama_agama Anolis_carolinensis Basiliscus_basiliscus Brachylophus_fasciatus Brookesia_brygooi Calotes_emma Chalarodon_madagascariensis Chamaeleo Corytophanes_cristatus Crotaphytus_collaris Dipsosaurus_dorsalis Enyalioides_laticeps Gambelia_wislizenii Hydrosaurus Leiocephalus_barahonensis Leiolepis_belliana Leiosaurus_catamarcensis Liolaemus_bellii Morunasaurus_annularis Oplurus_cyclurus Petrosaurus_mearnsi Phrynosoma_platyrhinos Phymaturus_palluma Physignathus_cocincinus Pogona_vitticeps Polychrus_marmoratus Pristidactylus_torquatus Sauromalus_ater Sceloporus_variabilis Stenocercus_guentheri Uma_scoparia Uranoscodon_superciliosus Uromastyx_aegyptus Urostrophus_vautieri Uta_stansburiana Plica_plica;
constraint ToxSA hard = Anniella_pulchra Celestus_enneagrammus Elgaria_multicarinata Heloderma_horridum Heloderma_suspectum Lanthanotus_borneensis Shinisaurus_crocodilurus Varanus_acanthurus Varanus_exanthematicus Varanus_salvator Xenosaurus_grandis Xenosaurus_platyceps Pseudopus_apodus Acrochordus_granulatus Anilius_scytale Liotyphlops_albirostris Boa_constrictor Calabaria_reinhardtii Epicrates_striatus Eryx_colubrinus Exiliboa_placata Lichanura_trivirgata Ungaliophis_continentalis Casarea_dussumieri Afronatrix_anoscopus Amphiesma_stolata Coluber_constrictor Diadophis_punctatus Homalopsis_buccata Lampropeltis_getula Natrix_natrix Pareas_hamptoni Thamnophis_marcianus Xenochrophis_piscator Xenodermus_javanicus Cylindrophis_rufus Aparallactus_werneri Atractaspis_irregularis Laticauda_colubrina Lycophidion_capense Micrurus_fulvius Naja Notechis_scutatus Leptotyphlops Loxocemus_bicolor Aspidites_melanocephalus Python_molurus Trachyboa_boulengeri Tropidophis_haetianus Typhlops_jamaicensis Uropeltis_melanogaster Agkistrodon_contortrix Azemiops_feae Bothrops_asper Causus Daboia_russelli Lachesis_muta Xenopeltis_unicolor;
constraint ToxSI hard = Agama_agama Anolis_carolinensis Basiliscus_basiliscus Brachylophus_fasciatus Brookesia_brygooi Calotes_emma Chalarodon_madagascariensis Chamaeleo Corytophanes_cristatus Crotaphytus_collaris Dipsosaurus_dorsalis Enyalioides_laticeps Gambelia_wislizenii Hydrosaurus Leiocephalus_barahonensis Leiolepis_belliana Leiosaurus_catamarcensis Liolaemus_bellii Morunasaurus_annularis Oplurus_cyclurus Petrosaurus_mearnsi Phrynosoma_platyrhinos Phymaturus_palluma Physignathus_cocincinus Pogona_vitticeps Polychrus_marmoratus Pristidactylus_torquatus Sauromalus_ater Sceloporus_variabilis Stenocercus_guentheri Uma_scoparia Uranoscodon_superciliosus Uromastyx_aegyptus Urostrophus_vautieri Uta_stansburiana Plica_plica Acrochordus_granulatus Anilius_scytale Liotyphlops_albirostris Boa_constrictor Calabaria_reinhardtii Epicrates_striatus Eryx_colubrinus Exiliboa_placata Lichanura_trivirgata Ungaliophis_continentalis Casarea_dussumieri Afronatrix_anoscopus Amphiesma_stolata Coluber_constrictor Diadophis_punctatus Homalopsis_buccata Lampropeltis_getula Natrix_natrix Pareas_hamptoni Thamnophis_marcianus Xenochrophis_piscator Xenodermus_javanicus Cylindrophis_rufus Aparallactus_werneri Atractaspis_irregularis Laticauda_colubrina Lycophidion_capense Micrurus_fulvius Naja Notechis_scutatus Leptotyphlops Loxocemus_bicolor Aspidites_melanocephalus Python_molurus Trachyboa_boulengeri Tropidophis_haetianus Typhlops_jamaicensis Uropeltis_melanogaster Agkistrodon_contortrix Azemiops_feae Bothrops_asper Causus Daboia_russelli Lachesis_muta Xenopeltis_unicolor;
